6
384
0	0	200	200	11	18	19	20	21	22	37	41	42	43	45	47	
200	0	200	200	18	9	11	12	13	14	15	16	17	26	28	35	36	37	38	39	40	44	50	
400	0	200	200	8	8	10	26	27	34	36	52	54	
0	200	200	200	0	
200	200	200	200	16	0	1	2	5	6	7	23	24	25	29	30	31	32	33	44	46	
400	200	200	200	10	3	4	25	29	31	48	49	51	52	53	
