8
400
0	0	200	200	9	15	16	17	18	1	30	41	71	83
200	0	200	200	11	18	10	20	2	42	43	44	54	72	73	74	
400	0	200	200	17	21	22	23	24	3	5	31	45	46	47	55	56	57	75	76	77	81	
600	0	200	200	13	25	26	27	28	4	32	48	49	51	78	79	80	81	
0	200	200	200	15	7	8	9	14	0	29	39	40	50	53	69	70	52  66  84
200	200	200	200	10	7	10	13	37	38	66	67	68  52  53	
400	200	200	200	13	7	11	13	35	36	52	60	63	64	65	82  53  66
600	200	200	200	11	6	7	12	13	33	34	58	59	61	62	82
