6
384
0	0	200	200	10	18	19	20	21	22	37	41	42	43	46	
200	0	200	200	18	9	11	12	13	14	15	16	17	26	28	35	36	37	38	39	40	44	45	
400	0	200	200	7	8	10	26	27	34	36	45	
0	200	200	200	0	
200	200	200	200	14	0	1	2	5	6	7	23	24	25	29	30	32	33	44	
400	200	200	200	5	3	4	25	29	31	
