0	0	0	512	384	4	0
01	0	0	256	192	4	0
011	0	0	128	96	0	9	18	19	20	21	22	41	43	45	47
012	128	0	128	96	0	5	16	17	18	37	41
013	0	96	128	96	0	1	42
014	128	96	128	96	0	0
02	256	0	256	192	4	0
021	256	0	128	96	0	8	9	11	13	14	15	28	36	37
022	384	0	128	96	0	3	8	10	36
023	256	96	128	96	0	6	12	28	35	38	39	40
024	384	96	128	96	0	3	26	27	34
03	0	192	256	192	4	0
031	0	192	128	96	0	0
032	128	192	128	96	0	1	33
033	0	288	128	96	0	0
034	128	288	128	96	0	3	29	30	33
04	256	192	256	192	4	0
041	256	192	128	96	0	7	5	6	7	23	32	44	46
042	384	192	128	96	0	2	44	48
043	256	288	128	96	0	5	0	1	2	24	29
044	384	288	128	96	0	7	2	3	4	25	29	31	49
