0	0	0	768	192	4	0
01	0	0	384	96	0	0
02	384	0	384	96	4	0
021	384	0	192	48	0	0
022	576	0	192	48	0	0
023	384	48	192	48	0	0
024	576	48	192	48	0	1	0
03	0	96	384	96	4	0
031	0	96	192	48	0	2	1	8
032	192	96	192	48	0	4	2	3	10	11
033	0	144	192	48	0	3	1	6	8
034	192	144	192	48	0	5	2	3	6	10	11
04	384	96	384	96	4	0
041	384	96	192	48	0	4	4	5	9	12
042	576	96	192	48	0	1	0
043	384	144	192	48	0	5	4	5	6	9	12
044	576	144	192	48	0	2	0	6
