6
384
0	0	200	200	11	23	24	26	26	27	37	41	42	43	45	47
200	0	200	200	17	14	16	17	18	19	20	21	22	3	28	35	36	37	38	39	40	44	
400	0	200	200	6	13	15	3	4	34	36	
0	200	200	200	0	
200	200	200	200	15	5	6	7	10	11	12	0	1	2	29	30	32	33	44	46	
400	200	200	200	6	8	9	2	29	31	48
